R 640 420

NO ./textures/redbrick.xpm


SO ./textures/eagle_1.xpm

F 110,110,110

WE ./textures/greystone_1.xpm

EA ./textures/wood_1.xpm


C 135,205,235

S ./textures/barrel.xpm

11111111111
10000000001
10000200001
10000100001
10000100001
100002000W1
10000000001
10101110101
10100000101
10100000101
10111111101
10000000001
11110201111
11110001111
11111111111