R 640 480
NO ./textures/wood_1.xpm
SO ./textures/eagle_1.xpm
WE ./textures/greystone_1.xpm
EA ./textures/redbrick.xpm
S  ./textures/barrel.xpm

F 110,110,110
C 135,205,235

11111111111111111111111111
10000002000000000010000001
10000000000000000101000001
10000000000000000001000001
10000N00000020000000000001
10000000000000000000200001
10002000000000000000000001
10000000000000000000000001
11111111111111111111111111